111111111111111111111
100C000000000000000C1
1C000C111110000000111
100000000100C00000001
10C000000000000000001
1C000C111110000000001
100000000100C00000001
10C0000000000000P0001
1C000C111110000000001
100000000E100C0000001
111111111111111111111