111111111111111111111
10C000000000000000C01
1C00CP111110000001111
100000000100C00000001
10C000000000000000001
1C000C111110000000001
100000000100C00000001
10C000000000000000001
1C000C111110000000001
100000000E100C0000001
111111111111111111111