111111111111111111111
100000000000000000001
10000P111110000001111
100000000100000000001
100000000000000000001
100000111110000000001
100000000100000000001
100000000000000000001
1C0001111110000000001
100000000E10000000001
111111111111111111111