111111111111111111111
1000000C00P0C000000E1
111111111111111111111
