111111111111111111111111111111111111111111111111111111111111111111111111111111111111111111111111111111111111111111111111111111111111111111111111111111
1000000100CP000000C000C111110000000110C000C1111100000001111C000C11111000000011C000C111110000000110C000C1111100000001111C000C11111111111111111111111111
10C000000000E00000C00C00000000000000000C00000000000000000C11C000C11111000000011C000C111110000000110C000C1111100000001111C000C1111111111111111111111111
1C000C11111000000011C000C111110000000110C000C1111100000001111C000C11111000000011C000C111110000000110C000C1111100000001111C000C111111111111111111111111
100000000100C0000000C000C111110000000110C000C1111100000001111C000C11111000000011C000C111110000000110C000C1111100000001111C000C111111111111111111111111
100C00000000000000C00C00000000000000000C000000000000000000C11C000C11111000000011C000C111110000000110C000C1111100000001111C000C111111111111111111111111
1C000C11111000000011C000C111110000000110C000C1111100000001111C000C11111000000011C000C111110000000110C000C1111100000001111C000C111111111111111111111111
100000000100C0000000C000C111110000000110C000C1111100000001111C000C11111000000011C000C111110000000110C000C1111100000001111C000C111111111111111111111111
100C000000000000000C00C00000000000000000C00000000000000000C11C000C11111000000011C000C111110000000110C000C1111100000001111C000C111111111111111111111111
1C000C11111000000011C000C111110000000110C000C1111100000001111C000C11111000000011C000C111110000000110C000C1111100000001111C000C111111111111111111111111
100000000100C0000000C000C111110000000110C000C1111100000001111C000C11111000000011C000C111110000000110C000C1111100000001111C000C111111111111111111111111
100C00000000000000C00C00000000000000000C000000000000000000C11C000C11111000000011C000C111110000000110C000C1111100000001111C000C111111111111111111111111
1C000C11111000000011C000C111110000000110C000C1111100000001111C000C11111000000011C000C111110000000110C000C1111100000001111C000C111111111111111111111111
100000000100C0000000C000C111110000000110C000C1111100000001111C000C11111000000011C000C111110000000110C000C1111100000001111C000C111111111111111111111111
100C000000000000000C00C00000000000000000C00000000000000000C11C000C11111000000011C000C111110000000110C000C1111100000001111C000C111111111111111111111111
1C000C11111000000011C000C111110000000110C000C1111100000001111C000C11111000000011C000C111110000000110C000C1111100000001111C000C111111111111111111111111
100000000100C0000000C000C111110000000110C000C1111100000001111C000C11111000000011C000C111110000000110C000C1111100000001111C000C111111111111111111111111
100C00000000000000C00C00000000000000000C000000000000000000C11C000C11111000000011C000C111110000000110C000C1111100000001111C000C111111111111111111111111
1C000C11111000000011C000C111110000000110C000C1111100000001111C000C11111000000011C000C111110000000110C000C1111100000001111C000C111111111111111111111111
100000000100C0000000C000C111110000000110C000C1111100000001111C000C11111000000011C000C111110000000110C000C1111100000001111C000C111111111111111111111111
100C000000000000000C00C00000000000000000C00000000000000000C11C000C11111000000011C000C111110000000110C000C1111100000001111C000C111111111111111111111111
1C000C11111000000011C000C111110000000110C000C1111100000001111C000C11111000000011C000C111110000000110C000C1111100000001111C000C111111111111111111111111
100000000100C0000000C000C111110000000110C000C1111100000001111C000C11111000000011C000C111110000000110C000C1111100000001111C000C111111111111111111111111
100C00000000000000C00C00000000000000000C000000000000000000C11C000C11111000000011C000C111110000000110C000C1111100000001111C000C111111111111111111111111
1C000C11111000000011C000C111110000000110C000C1111100000001111C000C11111000000011C000C111110000000110C000C1111100000001111C000C111111111111111111111111
100C000000000000000C00C00000000000000000C00000000000000000C11C000C11111000000011C000C111110000000110C000C1111100000001111C000C111111111111111111111111
1C000C11111000000011C000C111110000000110C000C1111100000001111C000C11111000000011C000C111110000000110C000C1111100000001111C000C111111111111111111111111
1C000C11111000000011C000C111110000000110C000C1111100000001111C000C11111000000011C000C111110000000110C000C1111100000001111C000C111111111111111111111111
100000000100C0000000C000C111110000000110C000C1111100000001111C000C11111000000011C000C111110000000110C000C1111100000001111C0011111111111111111111111111
100C00000000000000C00C00000000000000000C000000000000000000C11C000C11111000000011C000C111110000000110C000C1111100000001111C00C1111111111111111111111111
1C000C11111000000011C000C111110000000110C000C1111100000001111C000C11111000000011C000C111110000000110C000C1111100000001111C000C111111111111111111111111
100000000100C0000000C000C111110000000110C000C1111100000001111C000C11111000000011C000C111110000000110C000C1111100000001111C000C111111111111111111111111
100C000000000000000C00C00000000000000000C00000000000000000C11C000C11111000000011C000C111110000000110C000C1111100000001111C000C111111111111111111111111
1C000C11111000000011C000C111110000000110C000C1111100000001111C000C11111000000011C000C111110000000110C000C1111100000001111C000C111111111111111111111111
100000000100C0000000C000C111110000000110C000C1111100000001111C000C11111000000011C000C111110000000110C000C1111100000001111C000C111111111111111111111111
100C00000000000000C00C00000000000000000C000000000000000000C11C000C11111000000011C000C111110000000110C000C1111100000001111C000C111111111111111111111111
1C000C11111000000011C000C111110000000110C000C1111100000001111C000C11111000000011C000C111110000000110C000C1111100000001111C000C111111111111111111111111
111111111111111111111111111111111111111111111111111111111111111111111111111111111111111111111111111111111111111111111111111111111111111111111111111111