11111111111111111111111
1EC000C00000000000000P1
11111111111111111111111